sku,descripcion,costo_fabricacion,precio_venta,categoria,margen
CR-SML-4,Correa Smiley L,3,14,CORREA,11
AR-STC-3,ARNÉS AJUSTABLE STICKERS M,4,13,ARNÉS AJUSTABLE,9
AT-SML-3,ARNÉS TRAIL SMILEY M,7,19,ARNÉS TRAIL,12
AT-SML-2,ARNÉS TRAIL SMILEY S,7,18,ARNÉS TRAIL,11
CR-STC-4,CORREA STICKERS L,3,11,CORREA,8
AT-TAT-4,ARNÉS TRAIL TATTOO L,8,22,ARNÉS TRAIL,14
ACV-BLU-3,CLASSIC HARNESS PVC BLUE PVC M,5,19,PVC ARNÉS CLÁSICO,14
AC-GMM-3,Dukier Bears Gummy Arnés Clásico M,2,14,ARNÉS CLÁSICO,12
AT-BRY-2,ARNÉS TRAIL BERRY LOVE S,7,23,ARNÉS TRAIL,16
CR-PRP-4,Correa Purple L,3,14,CORREA,11
CR-GMM-2,Dukier Bears Gummy Correa S,2,16,CORREA,14
CL-BRY-3,Dukier Berry Love Collar M,2,12,COLLAR PERRO,10
RC-RPW-7,CHUBASQUEROS FLOWER POWER XXXL,5,13,CHUBASQUERO,8
AT-BRY-3,ARNÉS TRAIL BERRY LOVE M,7,24,ARNÉS TRAIL,17
ACV-BLU-4,CLASSIC HARNESS PVC BLUE PVC L,5,19,PVC ARNÉS CLÁSICO,14
AT-AVC-4,ARNÉS TRAIL AVOCADO L,8,23,ARNÉS TRAIL,15
RC-RPW-1,CHUBASQUEROS FLOWER POWER XS,5,19,CHUBASQUERO,14
BH-RED-1,Body Red XS,2,11,ARNÉS BODY,9
ACV-GRN-4,CLASSIC HARNESS PVC GREEN PVC L,5,19,PVC ARNÉS CLÁSICO,14
PB-STC-2,PORTA BOLSAS STICKERS U,2,5,PORTA BOLSAS,3
PB-SML-2,Porta Bolsas Smiley U,2,5,PORTA BOLSAS,3
ACV-PNK-4,CLASSIC HARNESS PVC PINK PVC L,5,19,PVC ARNÉS CLÁSICO,14
CR-RED-4,Correa Red L,3,14,CORREA,11
PJ-BRY-4,Dukier Berry Love Pajarita L,1,5,PAJARITA,4
AC-CLF-2,ARNÉS CLÁSICO CALIFORNIA S,2,10,ARNÉS CLÁSICO,8
CR-AVC-4,CORREA AVOCADO L,3,15,CORREA,12
ACV-BEI-4,CLASSIC HARNESS PVC BEIGE PVC L,5,19,PVC ARNÉS CLÁSICO,14
ACV-COR-4,0,5,20,PVC ARNÉS CLÁSICO,15
BH-TRT-5,BODY HARNESS TURTLEXL,3,11,ARNÉS BODY,8
CG-MNT-0,Collar Gato Mint U,1,6,GATO,5
CR-BLU-2,Correa Blue S,2,14,CORREA,12
PB-TDY-2,PORTA BOLSAS TIE DYE,2,4,PORTA BOLSAS,2
PB-PLN-2,PORTA BOLSAS PLANTS,2,4,PORTA BOLSAS,2
ACV-PRP-4,0,5,20,PVC ARNÉS CLÁSICO,15
CL-UNC-4,Collar UNICORNS L,2,11,COLLAR PERRO,9
ACV-SGR-4,0,5,20,PVC ARNÉS CLÁSICO,15
CL-UNC-3,Collar UNICORNS M,2,10,COLLAR PERRO,8
ACV-YEL-4,0,5,20,PVC ARNÉS CLÁSICO,15
CRV-BLU-4,LEASH PVC BLUE PVC L,4,18,PVC CORREA,14
AC-BLU-4,Arnés clásico Blue L,3,12,ARNÉS CLÁSICO,9
CG-BEE-0,Dukier Beer Collar Gato U,1,5,GATO,4
AR-DGT-1,ARNÉS REVERSIBLE DOGTELLA XS,3,14,ARNÉS REVERSIBLE,11
CL-SWT-3,Collar SWEETS M,2,11,COLLAR PERRO,9
AR-MON-5,Arnés Reversible Monstera XL,5,18,ARNÉS REVERSIBLE,13
BH-YLL-1,Body Lime XS,2,13,ARNÉS BODY,11
AC-SWT-3,ARNÉS CLÁSICO SWEETS M,2,12,ARNÉS CLÁSICO,10
CG-TER-0,Collar GATO TERRAZO U,1,4,GATO,3
AC-MMD-4,Dukier Mermaid Arnés Clásico L,3,14,ARNÉS CLÁSICO,11
AR-PKG-4,ARNÉS REVERSIBLE PINK GALAXY L,4,18,ARNÉS REVERSIBLE,14
AR-PCE-4,Dukier Peace Arnés Reversible L,4,17,ARNÉS REVERSIBLE,13
CL-BEE-2,Dukier Beer Collar S,2,9,COLLAR PERRO,7
AT-MMD-5,ARNÉS TRAIL MERMAID XL,8,21,ARNÉS TRAIL,13
BH-YLL-2,Body Lime S,2,13,ARNÉS BODY,11
AR-AVC-4,ARNÉS REVERSIBLE AVOCADO L,4,16,ARNÉS REVERSIBLE,12
AC-YLL-4,Arnés Clásico Lime L,3,12,ARNÉS CLÁSICO,9
RC-CLD-6,Dukier Chubasqueros CLOUDS XXL,5,14,CHUBASQUERO,9
CG-RCK-0,Collar GATO ROCK U,1,4,GATO,3
CL-YLL-1,Collar Lime XS,1,9,COLLAR PERRO,8
BH-RED-5,Body Red XL,3,10,ARNÉS BODY,7
RC-RBW-2,Chubasqueros Rainbow S,5,11,CHUBASQUERO,6
CL-SWT-1,Collar SWEETS XS,1,10,COLLAR PERRO,9
RC-RND-3,Dukier Chubasqueros Raindrops M,5,13,CHUBASQUERO,8
AR-MON-4,Arnés Reversible Monstera L,4,15,ARNÉS REVERSIBLE,11
CR-MNT-4,Correa Mint L,3,14,CORREA,11
AR-DGT-2,ARNÉS REVERSIBLE DOGTELLA S,3,14,ARNÉS REVERSIBLE,11
AC-AVC-2,ARNÉS CLÁSICO AVOCADO S,2,13,ARNÉS CLÁSICO,11
AR-TAT-2,ARNES REVERSIBLE TATTOO S,3,16,ARNÉS REVERSIBLE,13
BH-SML-1,Body Smiley XS,2,13,ARNÉS BODY,11
AC-YLL-2,Arnés Clásico Lime S,2,12,ARNÉS CLÁSICO,10
AC-SWT-2,ARNÉS CLÁSICO SWEETS S,2,13,ARNÉS CLÁSICO,11
BH-SBL-5,BODY HARNESS SOFT BLUE XL,2,6,ARNÉS BODY,4
MN-TRT-0,Manta enrollableTurtle U,8,23,MANTA ENROLLABLE,15
BH-TRT-4,BODY HARNESS TURTLE L,3,11,ARNÉS BODY,8
RC-STM-2,Chubasqueros Storm S,5,12,CHUBASQUERO,7
AC-FPW-4,ARNÉS CLÁSICO FLOWER POWER L,3,14,ARNÉS CLÁSICO,11
BH-YLL-5,Body Lime XL,3,12,ARNÉS BODY,9
RC-RBW-3,Chubasqueros Rainbow M,5,10,CHUBASQUERO,5
CR-SWT-4,CORREA SWEETS L,3,16,CORREA,13
AR-TRT-5,ARNÉS REVERSIBLE TURTLE XL,5,14,ARNÉS REVERSIBLE,9
AR-GMM-3,Dukier Bears Gummy Arnés Ajustable M,4,16,ARNÉS AJUSTABLE,12
AT-CLF-4,ARNÉS TRAIL CALIFORNIA L,8,21,ARNÉS TRAIL,13
CL-BEE-3,Dukier Beer Collar M,2,11,COLLAR PERRO,9
AR-SML-1,Arnés Ajustable Smiley XS,3,16,ARNÉS AJUSTABLE,13
CT-BRY-0,COLETERO BERRY LOVE U,1,6,COLETERO,5
CR-BEE-2,Dukier Beer Correa S,2,16,CORREA,14
CR-MMD-4,Dukier Mermaid Correa L,3,16,CORREA,13
AT-TAT-2,ARNÉS TRAIL TATTOO S,7,23,ARNÉS TRAIL,16
RC-RPW-2,CHUBASQUEROS FLOWER POWER S,5,19,CHUBASQUERO,14
CR-CLF-4,CORREA CALIFORNIA L,3,13,CORREA,10
AT-FPW-3,Arnés Trail Flower Power M,7,25,ARNÉS TRAIL,18
MN-DGT-0,Manta enrollable Dogtella U,8,21,MANTA ENROLLABLE,13
AR-GMM-2,Dukier Bears Gummy Arnés Ajustable S,3,17,ARNÉS AJUSTABLE,14
AC-PRP-4,Arnés Clásico Purple L,3,11,ARNÉS CLÁSICO,8
AR-SML-3,Arnés Ajustable Smiley M,4,16,ARNÉS AJUSTABLE,12
BH-YLL-3,Body Lime M,2,12,ARNÉS BODY,10
CO-GRN-2,GREEN COAT S,6,23,ABRIGO,17
BH-TAT-1,BODY HARNESS TATTOO XS,2,6,ARNÉS BODY,4
AT-ALN-2,ARNÉS TRAIL ALIEN S,8,24,ARNÉS TRAIL,16
RC-STM-3,Chubasqueros Storm M,5,12,CHUBASQUERO,7
AC-AVC-3,ARNÉS CLÁSICO AVOCADO M,2,13,ARNÉS CLÁSICO,11
AR-MMD-5,Dukier Mermaid Arnés Reversible Xl,5,15,ARNÉS REVERSIBLE,10
ACV-BEI-3,CLASSIC HARNESS PVC BEIGE PVC M,5,19,PVC ARNÉS CLÁSICO,14
BH-RED-2,Body Red S,2,12,ARNÉS BODY,10
AR-FPW-4,ARNÉS AJUSTABLE FLOWER POWER L,4,17,ARNÉS AJUSTABLE,13
RC-STM-4,Chubasqueros Storm L,5,12,CHUBASQUERO,7
PJ-SML-4,Pajarita Smiley L,1,5,PAJARITA,4
BH-DGT-1,Body Dogtella XS,2,12,ARNÉS BODY,10
AR-AVC-2,ARNÉS REVERSIBLE AVOCADO S,3,15,ARNÉS REVERSIBLE,12
AR-AVC-1,ARNÉS REVERSIBLE AVOCADO XS,3,15,ARNÉS REVERSIBLE,12
RC-CLD-4,Dukier Chubasqueros Clouds L,5,14,CHUBASQUERO,9
AT-BRY-5,ARNÉS TRAIL BERRY LOVE XL,8,22,ARNÉS TRAIL,14
AT-CLF-5,ARNÉS TRAIL CALIFORNIA XL,8,19,ARNÉS TRAIL,11
AT-MMD-4,ARNÉS TRAIL MERMAID L,8,24,ARNÉS TRAIL,16
AR-TAT-1,ARNES REVERSIBLE TATTOO XS,3,16,ARNÉS REVERSIBLE,13
ACV-PNK-3,CLASSIC HARNESS PVC PINK PVC M,5,19,PVC ARNÉS CLÁSICO,14
CR-SML-2,Correa Smiley S,2,15,CORREA,13
RC-STM-6,Chubasqueros Storm XXL,5,13,CHUBASQUERO,8
BH-AVC-1,Body Avocado XS,2,11,ARNÉS BODY,9
ACV-COR-3,0,5,19,PVC ARNÉS CLÁSICO,14
AT-FPW-5,Arnés Trail Flower Power Xl,8,23,ARNÉS TRAIL,15
PB-PRP-2,Porta Bolsas Purple U,2,6,PORTA BOLSAS,4
RC-RND-5,Dukier Chubasqueros Raindrops Xl,5,13,CHUBASQUERO,8
CL-STC-3,Collar STICKERS M,2,9,COLLAR PERRO,7
MN-GMM-0,Manta Enrollable Gummy Bears,8,22,MANTA ENROLLABLE,14
AT-TRT-4,ARNÉS TRAIL TURTLE L,8,24,ARNÉS TRAIL,16
PB-PNK-2,Porta Bolsas Pink U,2,6,PORTA BOLSAS,4
CLV-BLU-1,COLLAR PVC BLUE PVC XS,2,16,PVC COLLAR PERRO,14
AR-LPG-4,Arnés Ajustable Cheetah Gold L,4,14,ARNÉS AJUSTABLE,10
AC-BLU-3,Arnés clásico Blue M,2,12,ARNÉS CLÁSICO,10
AT-GMM-4,ARNÉS TRAIL GUMMY BEARS L,8,24,ARNÉS TRAIL,16
CLV-GRN-1,COLLAR PVC GREEN PVC XS,2,12,PVC COLLAR PERRO,10
AR-FPW-1,ARNÉS AJUSTABLE FLOWER POWER XS,3,17,ARNÉS AJUSTABLE,14
CR-BLU-4,Correa Blue L,3,14,CORREA,11
AC-STC-4,ARNÉS CLÁSICO STICKERS L,3,9,ARNÉS CLÁSICO,6
AR-GMM-5,Dukier Bears Gummy Arnés Ajustable Xl,5,16,ARNÉS AJUSTABLE,11
CL-GMM-2,Dukier Bears Gummy Collar S,2,11,COLLAR PERRO,9
ACV-PRP-3,0,5,19,PVC ARNÉS CLÁSICO,14
AC-UNC-2,ARNÉS CLÁSICO UNICORNS S,2,13,ARNÉS CLÁSICO,11
ACV-SGR-3,0,5,19,PVC ARNÉS CLÁSICO,14
AT-SML-4,ARNÉS TRAIL SMILEY L,8,19,ARNÉS TRAIL,11
ACV-YEL-3,0,5,19,PVC ARNÉS CLÁSICO,14
AC-BEE-4,Dukier Beer Arnés Clásico L,3,14,ARNÉS CLÁSICO,11
CLV-PNK-3,COLLAR PVC PINK PVC M,3,14,PVC COLLAR PERRO,11
BH-FPW-3,BODY HARNESS FLOWER POWER M,2,10,ARNÉS BODY,8
AR-MMD-3,Dukier Mermaid Arnés Reversible M,4,15,ARNÉS REVERSIBLE,11
CL-DGT-1,Collar DOGTELLA XS,1,9,COLLAR PERRO,8
CR-FPW-2,CORREA FLOWER POWER S,2,13,CORREA,11
BH-PNK-4,Body Pink L,3,13,ARNÉS BODY,10
AT-GMM-5,ARNÉS TRAIL GUMMY BEARS XL,8,22,ARNÉS TRAIL,14
AC-TAT-3,ARNES CLÁSICO TATTOO M,2,11,ARNÉS CLÁSICO,9
AT-FPW-4,Arnés Trail Flower Power L,8,25,ARNÉS TRAIL,17
AR-SML-2,Arnés Ajustable Smiley S,3,16,ARNÉS AJUSTABLE,13
CRV-BEI-4,LEASH PVC BEIGE PVC L,4,18,PVC CORREA,14
CL-MMD-4,Dukier Mermaid Collar L,2,13,COLLAR PERRO,11
AC-LPG-2,Arnés Clásico Cheetah Gold S,2,11,ARNÉS CLÁSICO,9
AR-STC-5,ARNÉS AJUSTABLE STICKERS XL,5,13,ARNÉS AJUSTABLE,8
AR-PKG-3,ARNÉS REVERSIBLE PINK GALAXY M,4,18,ARNÉS REVERSIBLE,14
AT-SML-5,ARNÉS TRAIL SMILEY XL,8,19,ARNÉS TRAIL,11
AT-AVC-5,ARNÉS TRAIL AVOCADO XL,8,24,ARNÉS TRAIL,16
AT-TRT-5,ARNÉS TRAIL TURTLE XL,8,23,ARNÉS TRAIL,15
PJ-BEE-4,Dukier Beer Pajarita L,1,6,PAJARITA,5
AT-MON-5,0,8,33,ARNÉS TRAIL,25
MN-FPW-0,Manta enrollable Flower Power,8,24,MANTA ENROLLABLE,16
RC-RPW-3,CHUBASQUEROS FLOWER POWER M,5,20,CHUBASQUERO,15
AT-GMM-3,ARNÉS TRAIL GUMMY BEARS M,7,24,ARNÉS TRAIL,17
MN-BRY-0,Manta Enrollable Berry Love,8,22,MANTA ENROLLABLE,14
CL-LPG-4,Collar Cheetah Gold L,2,11,COLLAR PERRO,9
AR-MMD-4,Dukier Mermaid Arnés Reversible L,4,16,ARNÉS REVERSIBLE,12
RC-RBW-7,Chubasqueros Rainbow XXXL,5,11,CHUBASQUERO,6
MN-AVC-0,Manta enrollable Avocado U,8,23,MANTA ENROLLABLE,15
AR-TRT-1,ARNÉS REVERSIBLE TURTLE XS,3,14,ARNÉS REVERSIBLE,11
AR-STC-4,ARNÉS AJUSTABLE STICKERS L,4,13,ARNÉS AJUSTABLE,9
MN-SWT-0,Manta manta enrollable Sweets U,8,23,MANTA ENROLLABLE,15
AT-BRY-4,ARNÉS TRAIL BERRY LOVE L,8,23,ARNÉS TRAIL,15
AT-MON-4,0,8,31,ARNÉS TRAIL,23
PB-BEI-2,POO BAG HOLDER BEIGE U,2,8,PORTA BOLSAS,6
CL-AVC-3,Collar AVOCADO M,2,11,COLLAR PERRO,9
PB-BEE-2,Dukier Beer Porta Bolsas U,2,6,PORTA BOLSAS,4
CL-BEE-4,Dukier Beer Collar L,2,10,COLLAR PERRO,8
AT-MON-3,0,7,29,ARNÉS TRAIL,22
TW-NVY-0,Dukier Toallas Navy U,4,12,TOALLA,8
MN-CLF-0,Manta enrollable California U,8,22,MANTA ENROLLABLE,14
AT-TRT-2,ARNÉS TRAIL TURTLE S,7,25,ARNÉS TRAIL,18
AC-TAT-2,ARNES CLÁSICO TATTOO S,2,11,ARNÉS CLÁSICO,9
AT-DGT-2,ARNÉS TRAIL DOGTELLA S,7,21,ARNÉS TRAIL,14
RC-RND-2,Dukier Chubasqueros Raindrops S,5,14,CHUBASQUERO,9
AC-RED-4,Arnés Clásico Red L,3,12,ARNÉS CLÁSICO,9
CL-DGT-4,Collar DOGTELLA L,2,10,COLLAR PERRO,8
AC-CLF-3,ARNÉS CLÁSICO CALIFORNIA M,2,12,ARNÉS CLÁSICO,10
DG-YEL-0,COMEDERO DUKIER PINK,8,17,COMEDERO,9
AC-TER-4,CLASSIC HARNESS TERRACOTA L,2,9,ARNÉS CLÁSICO,7
CR-DGT-4,CORREA DOGTELLA L,3,15,CORREA,12
CL-MON-3,Collar Monstera M,2,13,COLLAR PERRO,11
AR-LPG-1,Arnés Ajustable Cheetah Gold XS,3,17,ARNÉS AJUSTABLE,14
CG-YLL-0,Collar Gato Lime U,1,6,GATO,5
CLV-PNK-1,COLLAR PVC PINK PVC XS,2,14,PVC COLLAR PERRO,12
AR-TRT-2,ARNÉS REVERSIBLE TURTLE S,3,16,ARNÉS REVERSIBLE,13
AR-ALN-1,ARNÉS AJUSTABLE ALIEN XS,3,19,ARNÉS AJUSTABLE,16
BH-TAT-5,BODY HARNESS TATTOO XL,3,11,ARNÉS BODY,8
BH-VIO-0,BODY HARNESS SOFT PURPLE XXS,2,6,ARNÉS BODY,4
BH-TER-3,BODY HARNESS TERRACOTA M,2,6,ARNÉS BODY,4
CRV-PNK-4,LEASH PVC PINK PVC L,4,18,PVC CORREA,14
BH-BRY-5,BODY HARNESS BERRY LOVE XL,3,11,ARNÉS BODY,8
AR-UNC-2,ARNÉS REVERSIBLE UNICORNS S,3,15,ARNÉS REVERSIBLE,12
RC-RPW-4,CHUBASQUEROS FLOWER POWER L,5,20,CHUBASQUERO,15
CL-CLF-1,Collar CALIFORNIA XS,1,9,COLLAR PERRO,8
BH-BRY-4,BODY HARNESS BERRY LOVE L,3,11,ARNÉS BODY,8
CL-YLL-4,Collar Lime L,2,9,COLLAR PERRO,7
AR-BRY-2,Dukier Berry Love Arnes Reversible S,3,16,ARNÉS REVERSIBLE,13
CL-TER-1,COLLAR TERRACOTA XS,1,6,COLLAR PERRO,5
BH-AVC-5,Body Avocado XL,3,11,ARNÉS BODY,8
CL-VIO-3,COLLAR SOFT PURPLE M,1,6,COLLAR PERRO,5
AR-BRY-1,Dukier Berry Love ArnÈs Reversible Xs,3,15,ARNÉS REVERSIBLE,12
PBV-BLU-2,POO BAG HOLDER BLUE PVC U,2,7,PVC PORTA BOLSAS,5
BH-BLU-1,Body Blue XS,2,11,ARNÉS BODY,9
BH-PNK-3,Body Pink M,2,10,ARNÉS BODY,8
AC-TRT-4,ARNÉS CLÁSICO TURTLE L,3,12,ARNÉS CLÁSICO,9
PB-BRY-2,Dukier Berry Love Porta Bolsas U,2,6,PORTA BOLSAS,4
BH-TAT-3,BODY HARNESS TATTOO M,2,10,ARNÉS BODY,8
CR-FPW-4,CORREA FLOWER POWER L,3,17,CORREA,14
CO-BLU-7,BLUE COAT XXXL,7,27,ABRIGO,20
CO-PNK-2,PINK COAT S,6,23,ABRIGO,17
CL-MMD-3,Dukier Mermaid Collar M,2,12,COLLAR PERRO,10
DG-PNK-0,COMEDERO DUKIER BLUE,8,16,COMEDERO,8
CR-BEI-4,LEASH BEIGE L,2,9,CORREA,7
CL-AVC-4,Collar AVOCADO L,2,10,COLLAR PERRO,8
CL-PRP-1,Collar Purple XS,1,10,COLLAR PERRO,9
DG-BLU-0,COMEDERO DUKIER YELLOW,8,16,COMEDERO,8
AR-UNC-1,ARNÉS REVERSIBLE UNICORNS XS,3,15,ARNÉS REVERSIBLE,12
AR-STC-1,ARNÉS AJUSTABLE STICKERS XS,3,13,ARNÉS AJUSTABLE,10
CL-SML-3,Collar Smiley M,2,9,COLLAR PERRO,7
BH-MNT-4,Body Mint L,3,11,ARNÉS BODY,8
PB-MON-2,POO BAG HOLDER CACA MONSTERA,2,7,PORTA BOLSAS,5
AC-BEE-2,Dukier Beer Arnés Clásico S,2,13,ARNÉS CLÁSICO,11
CL-PKG-3,Collar Pink GALAXY M,2,10,COLLAR PERRO,8
AF-PRP-0,LICK MAT PURPLE,3,12,LICK MAT,9
CRV-GRN-4,LEASH PVC GREEN PVC L,4,18,PVC CORREA,14
CL-GMM-4,Dukier Bears Gummy Collar L,2,12,COLLAR PERRO,10
AR-TAT-5,ARNES REVERSIBLE TATTOO XL,5,16,ARNÉS REVERSIBLE,11
CLV-BLU-2,COLLAR PVC BLUE PVC S,2,14,PVC COLLAR PERRO,12
AR-SWT-5,ARNÉS REVERSIBLE SWEETS XL,5,16,ARNÉS REVERSIBLE,11
PB-TAT-2,PORTA BOLSAS TATTOO,2,5,PORTA BOLSAS,3
RC-STM-7,Chubasqueros Storm XXXL,5,13,CHUBASQUERO,8
AT-TAT-3,ARNÉS TRAIL TATTOO M,7,21,ARNÉS TRAIL,14
AR-MMD-2,Dukier Mermaid Arnés Reversible S,3,16,ARNÉS REVERSIBLE,13
AC-DGT-4,ARNÉS CLÁSICO DOGTELLA L,3,10,ARNÉS CLÁSICO,7
CL-AVC-1,Collar AVOCADO XS,1,10,COLLAR PERRO,9
AT-ALN-3,ARNÉS TRAIL ALIEN M,7,24,ARNÉS TRAIL,17
PB-DGT-2,PORTA BOLSAS DOGTELLA,2,6,PORTA BOLSAS,4
BH-PRP-2,Body Purple S,2,12,ARNÉS BODY,10
CL-MMD-1,Dukier Mermaid Collar Xs,1,10,COLLAR PERRO,9
BH-PNK-1,Body Pink XS,2,12,ARNÉS BODY,10
CR-BRY-2,Dukier Berry Love Correa S,2,14,CORREA,12
BH-MNT-3,Body Mint M,2,11,ARNÉS BODY,9
AR-LPG-2,Arnés Ajustable Cheetah Gold S,3,15,ARNÉS AJUSTABLE,12
CL-MNT-1,Collar Mint XS,1,9,COLLAR PERRO,8
PBV-BLK-2,POO BAG HOLDER BLACK PVC U,2,6,PVC PORTA BOLSAS,4
BH-PRP-5,Body Purple XL,3,13,ARNÉS BODY,10
PC-FPW-U,COLGADOR FLOWER POWER U,1,5,COLGADOR DE BOLSAS,4
AT-MON-2,0,7,28,ARNÉS TRAIL,21
BK-CHR-U,BLANKET CHURROS,8,19,BLANKET,11
PBV-COR-2,0,2,8,PVC PORTA BOLSAS,6
PBV-PRP-2,0,2,8,PVC PORTA BOLSAS,6
PBV-SGR-2,0,2,8,PVC PORTA BOLSAS,6
CG-PKG-0,Collar GATO PINK GALAXY U,1,5,GATO,4
CL-PRP-4,Collar Purple L,2,9,COLLAR PERRO,7
RC-RBW-5,Chubasqueros Rainbow XL,5,12,CHUBASQUERO,7
BH-MNT-2,Body Mint S,2,11,ARNÉS BODY,9
AR-PCE-1,Dukier Peace Arnés Reversible Xs,3,15,ARNÉS REVERSIBLE,12
AC-PNK-3,Arnés Clásico Pink M,2,12,ARNÉS CLÁSICO,10
RC-RBW-1,Chubasqueros Rainbow XS,5,9,CHUBASQUERO,4
CL-FPW-1,Collar FLOWER POWER XS,1,11,COLLAR PERRO,10
BK-TRN-U,BLANKET TARTAN RED,8,15,BLANKET,7
PBV-YEL-2,0,2,8,PVC PORTA BOLSAS,6
AC-STC-2,ARNÉS CLÁSICO STICKERS S,2,15,ARNÉS CLÁSICO,13
CL-ALN-3,COLLAR ALIEN M,2,12,COLLAR PERRO,10
CLV-BEI-4,COLLAR PVC BEIGE PVC L,3,15,PVC COLLAR PERRO,12
PJ-LPG-4,Pajarita Cheetah Gold U,1,5,PAJARITA,4
AR-PCE-3,Dukier Peace Arnés Reversible M,4,16,ARNÉS REVERSIBLE,12
BH-GMM-3,BODY HARNESS GUMMY BEARS M,2,10,ARNÉS BODY,8
RC-RND-7,Dukier Chubasqueros RAINDROPS XXXL,5,13,CHUBASQUERO,8
CT-DGT-0,COLETERO DOGTELLA U,1,5,COLETERO,4
ACV-BLU-2,CLASSIC HARNESS PVC BLUE PVC S,4,19,PVC ARNÉS CLÁSICO,15
CRV-BLU-2,LEASH PVC BLUE PVC S,4,18,PVC CORREA,14
CL-FPW-4,Collar FLOWER POWER L,2,11,COLLAR PERRO,9
ACV-GRN-2,CLASSIC HARNESS PVC GREEN PVC S,4,19,PVC ARNÉS CLÁSICO,15
DP-YEL-0,BEBEDERO PLEGABLE PARA PERRO YELLOW,2,6,BEBEDEROS,4
ACV-BLK-4,CLASSIC HARNESS PVC BLACKPVC L,5,19,PVC ARNÉS CLÁSICO,14
RC-RBW-4,Chubasqueros Rainbow L,5,11,CHUBASQUERO,6
CRV-BEI-2,LEASH PVC BEIGE PVC S,4,18,PVC CORREA,14
BH-TAT-4,BODY HARNESS TATTOO L,3,11,ARNÉS BODY,8
CRV-PNK-2,LEASH PVC PINK PVC S,4,18,PVC CORREA,14
CL-ALN-2,COLLAR ALIEN S,2,13,COLLAR PERRO,11
CRV-GRN-2,LEASH PVC GREEN PVC S,4,18,PVC CORREA,14
CL-PRP-2,Collar Purple S,2,10,COLLAR PERRO,8
ACV-BEI-2,CLASSIC HARNESS PVC BEIGE PVC S,4,19,PVC ARNÉS CLÁSICO,15
ACV-COR-2,0,4,17,PVC ARNÉS CLÁSICO,13
BH-GMM-2,BODY HARNESS GUMMY BEARS S,2,9,ARNÉS BODY,7
ACV-PRP-2,0,4,17,PVC ARNÉS CLÁSICO,13
ACV-SGR-2,0,4,17,PVC ARNÉS CLÁSICO,13
ACV-YEL-2,0,4,17,PVC ARNÉS CLÁSICO,13
BK-TRR-U,BLANKET TARTAN GREEN,8,17,BLANKET,9
PB-AVC-2,PORTA BOLSAS AVOCADO,2,5,PORTA BOLSAS,3
AF-BLU-0,LICK MAT BLUE,3,12,LICK MAT,9
AT-DGT-5,ARNÉS TRAIL DOGTELLA XL,8,20,ARNÉS TRAIL,12
CL-ALN-1,COLLAR ALIEN XS,1,11,COLLAR PERRO,10
PJ-FPW-4,PAJARITA FLOWER POWER L,1,5,PAJARITA,4
BH-BLU-2,Body Blue S,2,9,ARNÉS BODY,7
CL-PNK-4,Collar Pink L,2,10,COLLAR PERRO,8
BH-BLU-3,Body Blue M,2,11,ARNÉS BODY,9
BH-FPW-4,BODY HARNESS FLOWER POWER L,3,11,ARNÉS BODY,8
PB-SGR-2,POO BAG HOLDER SOFT GREEN U,2,8,PORTA BOLSAS,6
AC-BRY-3,Dukier Berry Love ArnÈs Clásico M,2,14,ARNÉS CLÁSICO,12
BH-MNT-5,Body Mint XL,3,12,ARNÉS BODY,9
AT-TAT-5,ARNÉS TRAIL TATTOO XL,8,20,ARNÉS TRAIL,12
CL-STC-4,Collar STICKERS L,2,8,COLLAR PERRO,6
ACV-BLK-3,CLASSIC HARNESS PVC BLACK PVC M,5,19,PVC ARNÉS CLÁSICO,14
AC-STC-3,ARNÉS CLÁSICO STICKERS M,2,10,ARNÉS CLÁSICO,8
MN-SML-0,Manta enrollable Smiley U,8,24,MANTA ENROLLABLE,16
CG-PLN-0,Collar GATO PLANTS U,1,4,GATO,3
RC-AVC-7,Dukier Chubasqueros AVOCADO XXXL,5,13,CHUBASQUERO,8
RC-RND-6,Dukier Chubasqueros RAINDROPS XXL,5,12,CHUBASQUERO,7
BH-FPW-5,BODY HARNESS FLOWER POWER XL,3,11,ARNÉS BODY,8
AR-CLF-5,ARNÉS REVERSIBLE CALIFORNIA XL,5,13,ARNÉS REVERSIBLE,8
CL-MNT-3,Collar Mint M,2,10,COLLAR PERRO,8
AR-ALN-5,ARNÉS AJUSTABLE ALIEN XL,5,16,ARNÉS AJUSTABLE,11
CR-PLN-2,CORREA PLANTS S,2,17,CORREA,15
PBV-PNK-2,POO BAG HOLDER PINK PVC U,2,6,PVC PORTA BOLSAS,4
AC-LPG-3,Arnés Clásico Cheetah Gold M,2,11,ARNÉS CLÁSICO,9
CL-BRY-4,Dukier Berry Love Collar L,2,12,COLLAR PERRO,10
CR-DGT-2,CORREA DOGTELLA S,2,15,CORREA,13
AR-CLF-4,ARNÉS REVERSIBLE CALIFORNIA L,4,14,ARNÉS REVERSIBLE,10
AR-PCE-5,Dukier Peace Arnés Reversible XL,5,18,ARNÉS REVERSIBLE,13
RC-AVC-3,Dukier Chubasqueros Avocado M,5,10,CHUBASQUERO,5
AR-FPW-5,ARNÉS AJUSTABLE FLOWER POWER XL,5,14,ARNÉS AJUSTABLE,9
CR-TRT-4,CORREA TURTLE L,3,15,CORREA,12
CL-FPW-3,Collar FLOWER POWER M,2,12,COLLAR PERRO,10
CL-PNK-2,Collar Pink S,2,10,COLLAR PERRO,8
AR-ALN-4,ARNÉS AJUSTABLE ALIEN L,4,20,ARNÉS AJUSTABLE,16
CLV-BLU-3,COLLAR PVC BLUE PVC M,3,14,PVC COLLAR PERRO,11
CL-RED-4,Collar Red L,2,9,COLLAR PERRO,7
CL-BRY-1,Dukier Berry Love Collar Xs,1,11,COLLAR PERRO,10
CO-RED-2,RED COAT S,6,23,ABRIGO,17
AC-RED-2,Arnés Clásico Red S,2,12,ARNÉS CLÁSICO,10
BH-PNK-5,Body Pink XL,3,12,ARNÉS BODY,9
CR-BRY-4,Dukier Berry Love Correa L,3,16,CORREA,13
AR-SWT-2,ARNÉS REVERSIBLE SWEETS S,3,16,ARNÉS REVERSIBLE,13
AC-MON-4,Arnés Clásico Monstera L,3,15,ARNÉS CLÁSICO,12
AR-TAT-4,ARNES REVERSIBLE TATTOO L,4,16,ARNÉS REVERSIBLE,12
AR-SWT-4,ARNÉS REVERSIBLE SWEETS L,4,17,ARNÉS REVERSIBLE,13
CT-SML-0,COLETERO SMILEY U,1,5,COLETERO,4
PB-PCE-2,Dukier Peace Porta Bolsas U,2,6,PORTA BOLSAS,4
AR-LPG-5,Arnés Ajustable Cheetah Gold XL,5,18,ARNÉS AJUSTABLE,13
AR-BEE-5,Dukier Beer Arnés Ajustable Xl,5,16,ARNÉS AJUSTABLE,11
AR-BEE-3,Dukier Beer Arnés Ajustable M,4,18,ARNÉS AJUSTABLE,14
AC-SML-3,Arnés Clásico Smiley M,2,13,ARNÉS CLÁSICO,11
RC-CLD-7,Dukier Chubasqueros CLOUDS XXXL,5,12,CHUBASQUERO,7
ACV-BLK-2,CLASSIC HARNESS PVC BLACK PVC S,4,19,PVC ARNÉS CLÁSICO,15
DP-RED-0,BEBEDERO PLEGABLE PARA PERRO RED,2,7,BEBEDEROS,5
CL-VIO-1,COLLAR SOFT PURPLE XS,1,6,COLLAR PERRO,5
AR-ALN-3,ARNÉS AJUSTABLE ALIEN M,4,18,ARNÉS AJUSTABLE,14
AC-VIO-4,CLASSIC HARNESS SOFT PURPLE L,2,9,ARNÉS CLÁSICO,7
DP-GRN-0,BEBEDERO PLEGABLE PARA PERRO GREEN,2,6,BEBEDEROS,4
CL-SML-2,Collar Smiley S,2,12,COLLAR PERRO,10
CL-ALN-4,COLLAR ALIEN L,2,12,COLLAR PERRO,10
DP-BLE-0,BEBEDERO PLEGABLE PARA PERRO BLUE,2,7,BEBEDEROS,5
BH-AVC-3,Body Avocado M,2,12,ARNÉS BODY,10
RC-STM-5,Chubasqueros Storm XL,5,13,CHUBASQUERO,8
CO-PRP-3,PURPLE COAT M,6,24,ABRIGO,18
DP-PNK-0,BEBEDERO PLEGABLE PARA PERRO PINK,2,7,BEBEDEROS,5
AT-FPW-2,Arnés Trail Flower Power S,7,25,ARNÉS TRAIL,18
DP-BLU-0,Bebedero Plegable Mint,2,7,BEBEDEROS,5
ACV-PNK-2,CLASSIC HARNESS PVC PINK PVC S,4,19,PVC ARNÉS CLÁSICO,15
PB-DUK-2,PORTA BOLSAS LOGO DUKIER,2,6,PORTA BOLSAS,4
BH-YLL-4,Body Lime L,3,14,ARNÉS BODY,11
CR-TRT-2,CORREA TURTLE S,2,14,CORREA,12
CL-MMD-2,Dukier Mermaid Collar S,2,11,COLLAR PERRO,9
CL-GMM-3,Dukier Bears Gummy Collar M,2,12,COLLAR PERRO,10
CLV-BLU-4,COLLAR PVC BLUE PVC L,3,14,PVC COLLAR PERRO,11
CRV-BLK-4,LEASH PVC BLACK PVC L,4,18,PVC CORREA,14
CR-SGR-2,LEASH SOFT GREEN S,2,9,CORREA,7
CL-YLL-3,Collar Lime M,2,10,COLLAR PERRO,8
CLV-BLK-2,COLLAR PVC BLACK PVC S,2,14,PVC COLLAR PERRO,12
CL-SML-1,Collar Smiley XS,1,11,COLLAR PERRO,10
AC-AVC-4,ARNÉS CLÁSICO AVOCADO L,3,13,ARNÉS CLÁSICO,10
RC-CLD-5,Dukier Chubasqueros Clouds Xl,5,14,CHUBASQUERO,9
AR-GMM-4,Dukier Bears Gummy Arnés Ajustable L,4,18,ARNÉS AJUSTABLE,14
AC-SML-2,Arnés Clásico Smiley S,2,13,ARNÉS CLÁSICO,11
PB-MMD-2,Dukier Mermaid Porta Bolsas U,2,6,PORTA BOLSAS,4
RC-STM-1,Chubasqueros Storm XS,5,11,CHUBASQUERO,6
AR-FPW-3,ARNÉS AJUSTABLE FLOWER POWER M,4,17,ARNÉS AJUSTABLE,13
BH-BRY-2,BODY HARNESS BERRY LOVE S,2,9,ARNÉS BODY,7
AT-ALN-5,ARNÉS TRAIL ALIEN XL,8,24,ARNÉS TRAIL,16
BH-TAT-2,BODY HARNESS TATTOO S,2,9,ARNÉS BODY,7
CR-AVC-2,CORREA AVOCADO S,2,12,CORREA,10
BH-DGT-3,Body Dogtella M,2,12,ARNÉS BODY,10
BH-SML-5,Body Smiley XL,3,13,ARNÉS BODY,10
TW-AVC-0,Dukier Toallas Avocado U,4,12,TOALLA,8
PC-SWT-U,COLGADOR DE BOLSAS SWEETS U,1,5,COLGADOR DE BOLSAS,4
PB-VIO-2,POO BAG HOLDER SOFT PURPLE U,2,8,PORTA BOLSAS,6
TW-MMD-0,Dukier Toallas Mermaid U,4,13,TOALLA,9
PB-FPW-2,PORTA BOLSAS FLOWER POWER U,2,5,PORTA BOLSAS,3
CL-BRY-2,Dukier Berry Love Collar S,2,12,COLLAR PERRO,10
AT-MMD-2,ARNÉS TRAIL MERMAID S,7,23,ARNÉS TRAIL,16
BH-SML-4,Body Smiley L,3,12,ARNÉS BODY,9
AC-GMM-2,Dukier Bears Gummy Arnés Clásico S,2,14,ARNÉS CLÁSICO,12
PB-CLF-2,PORTA BOLSAS CALIFORNIA U,2,5,PORTA BOLSAS,3
AC-DGT-2,ARNÉS CLÁSICO DOGTELLA S,2,12,ARNÉS CLÁSICO,10
AC-UNC-4,ARNÉS CLÁSICO UNICORNS L,3,12,ARNÉS CLÁSICO,9
PC-TRT-U,COLGADOR DE BOLSAS TURTLE U,1,6,COLGADOR DE BOLSAS,5
CL-PCE-2,Dukier Peace Collar S,2,11,COLLAR PERRO,9
PB-BLU-2,Porta Bolsas Blue U,2,5,PORTA BOLSAS,3
CL-PNK-1,Collar Pink XS,1,8,COLLAR PERRO,7
AC-LPG-4,Arnés Clásico Cheetah Gold L,3,13,ARNÉS CLÁSICO,10
CR-LPG-4,Correa Cheetah Gold L,3,16,CORREA,13
AT-AVC-2,ARNÉS TRAIL AVOCADO S,7,23,ARNÉS TRAIL,16
PB-TRT-2,PORTA BOLSAS TURTLE,2,6,PORTA BOLSAS,4
AR-FPW-2,ARNÉS AJUSTABLE FLOWER POWER S,3,17,ARNÉS AJUSTABLE,14
CR-VIO-2,LEASH SOFT PURPLE S,2,9,CORREA,7
AC-BRY-2,Dukier Berry Love ArnÈs Clásico S,2,13,ARNÉS CLÁSICO,11
CR-SGR-4,LEASH SOFT GREEN L,2,9,CORREA,7
CL-YLL-2,Collar Lime S,2,10,COLLAR PERRO,8
AC-TRT-2,ARNÉS CLÁSICO TURTLE S,2,13,ARNÉS CLÁSICO,11
BH-TRT-2,BODY HARNESS TURTLE S,2,9,ARNÉS BODY,7
AF-YEL-0,LICK MAT YELLOW,3,12,LICK MAT,9
AF-PNK-0,LICK MAT PINK,3,12,LICK MAT,9
FD-BLU-4,FUNDA CAMA BLUE L,,,CAMA FUNDA,
FD-TRC-2,FUNDA CAMA TERRACOTA S,,,CAMA FUNDA,
AC-TER-2,CLASSIC HARNESS TERRACOTA S,2,9,ARNÉS CLÁSICO,7
AC-SBL-2,CLASSIC HARNESS SOFT BLUE S,2,9,ARNÉS CLÁSICO,7
BH-SGR-2,BODY HARNESS SOFT GREEN S,2,6,ARNÉS BODY,4
BH-VIO-2,BODY HARNESS SOFT PURPLE S,2,6,ARNÉS BODY,4
BH-SGR-1,BODY HARNESS SOFT GREEN XS,2,6,ARNÉS BODY,4
BH-TER-0,BODY HARNESS TERRACOTA XXS,2,6,ARNÉS BODY,4
BH-BEI-0,BODY HARNESS BEIGE XXS,2,6,ARNÉS BODY,4
CG-AVC-0,Collar GATO AVOCADO U,1,5,GATO,4
CL-PCE-4,Dukier Peace Collar L,2,12,COLLAR PERRO,10
BH-BEI-2,BODY HARNESS BEIGE S,2,6,ARNÉS BODY,4
BH-BEI-3,BODY HARNESS BEIGE M,2,6,ARNÉS BODY,4
BH-SBL-1,BODY HARNESS SOFT BLUE XS,2,6,ARNÉS BODY,4
BH-SBL-3,BODY HARNESS SOFT BLUE M,2,6,ARNÉS BODY,4
BH-SBL-4,BODY HARNESS SOFT BLUE L,2,6,ARNÉS BODY,4
BH-SBL-0,BODY HARNESS SOFT BLUE XXS,2,6,ARNÉS BODY,4
BH-SGR-5,BODY HARNESS SOFT GREEN XL,2,6,ARNÉS BODY,4
BH-VIO-1,BODY HARNESS SOFT PURPLE XS,2,6,ARNÉS BODY,4
AC-BEI-2,CLASSIC HARNESS BEIGE S,2,9,ARNÉS CLÁSICO,7
AC-SBL-4,CLASSIC HARNESS SOFT BLUE L,2,9,ARNÉS CLÁSICO,7
BH-VIO-3,BODY HARNESS SOFT PURPLE M,2,6,ARNÉS BODY,4
BH-VIO-4,BODY HARNESS SOFT PURPLE L,2,6,ARNÉS BODY,4
BH-VIO-5,BODY HARNESS SOFT PURPLE XL,2,6,ARNÉS BODY,4
BH-TER-4,BODY HARNESS TERRACOTA L,2,6,ARNÉS BODY,4
CL-BEI-2,COLLAR BEIGE S,1,6,COLLAR PERRO,5
CL-SBL-3,COLLAR SOFT BLUE M,1,6,COLLAR PERRO,5
CL-SGR-3,COLLAR SOFT GREEN M,1,6,COLLAR PERRO,5
CL-SGR-4,COLLAR SOFT GREEN L,1,6,COLLAR PERRO,5
CL-VIO-4,COLLAR SOFT PURPLE L,1,6,COLLAR PERRO,5
BH-GMM-4,BODY HARNESS GUMMY BEARS L,3,11,ARNÉS BODY,8
BH-GMM-5,BODY HARNESS GUMMY BEARS XL,3,11,ARNÉS BODY,8
BH-BEI-1,BODY HARNESS BEIGE XS,2,6,ARNÉS BODY,4
AC-BEI-3,CLASSIC HARNESS BEIGE M,2,9,ARNÉS CLÁSICO,7
CL-TER-4,COLLAR TERRACOTA L,1,6,COLLAR PERRO,5
PB-GMM-2,Dukier Bears Gummy Porta Bolsas U,2,6,PORTA BOLSAS,4
CR-PKG-4,CORREA PINK GALAXY L,3,17,CORREA,14
CR-MON-4,Correa Monstera L,3,17,CORREA,14
CLV-BLK-4,COLLAR PVC BLACK PVC L,3,13,PVC COLLAR PERRO,10
CLV-PNK-4,COLLAR PVC PINK PVC L,3,14,PVC COLLAR PERRO,11
BH-SGR-3,BODY HARNESS SOFT GREEN M,2,6,ARNÉS BODY,4
BH-BEI-4,BODY HARNESS BEIGE L,2,6,ARNÉS BODY,4
BH-SGR-4,BODY HARNESS SOFT GREEN L,2,6,ARNÉS BODY,4
BH-TER-1,BODY HARNESS TERRACOTA XS,2,6,ARNÉS BODY,4
AC-YLL-3,Arnés Clásico Lime M,2,12,ARNÉS CLÁSICO,10
CL-UNC-2,Collar UNICORNS S,2,11,COLLAR PERRO,9
AR-MON-3,Arnés Reversible Monstera M,4,17,ARNÉS REVERSIBLE,13
CLV-GRN-4,COLLAR PVC GREEN PVC L,3,14,PVC COLLAR PERRO,11
AT-CLF-3,ARNÉS TRAIL CALIFORNIA M,7,19,ARNÉS TRAIL,12
CL-SML-4,Collar Smiley L,2,9,COLLAR PERRO,7
AR-UNC-5,ARNÉS REVERSIBLE UNICORNS XL,5,13,ARNÉS REVERSIBLE,8
CLV-PRP-4,0,3,12,PVC COLLAR PERRO,9
BH-PRP-4,Body Purple L,3,12,ARNÉS BODY,9
CG-UNC-0,Collar GATO UNICORNS U,1,6,GATO,5
AC-SML-4,Arnés Clásico Smiley L,3,13,ARNÉS CLÁSICO,10
AT-AVC-3,ARNÉS TRAIL AVOCADO M,7,23,ARNÉS TRAIL,16
CLV-COR-4,0,3,12,PVC COLLAR PERRO,9
CL-PCE-3,Dukier Peace Collar M,2,12,COLLAR PERRO,10
FD-MNT-2,FUNDA CAMA MINT S,,,CAMA FUNDA,
AT-DGT-4,ARNÉS TRAIL DOGTELLA L,8,22,ARNÉS TRAIL,14
BH-PNK-2,Body Pink S,2,11,ARNÉS BODY,9
RC-CLD-2,Dukier Chubasqueros Clouds S,5,14,CHUBASQUERO,9
PB-RED-2,Porta Bolsas Red U,2,6,PORTA BOLSAS,4
RC-CLD-3,Dukier Chubasqueros Clouds M,5,12,CHUBASQUERO,7
PC-UNC-U,COLGADOR DE BOLSAS UNICORNS U,1,5,COLGADOR DE BOLSAS,4
CO-RED-1,RED COAT,6,22,ABRIGO,16
CL-TAT-2,Collar TATTOO S,2,11,COLLAR PERRO,9
AC-MON-3,Arnés Clásico Monstera M,2,16,ARNÉS CLÁSICO,14
CL-TRT-3,Collar TURTLE M,2,11,COLLAR PERRO,9
CLV-SGR-4,0,3,12,PVC COLLAR PERRO,9
BH-SML-2,Body Smiley S,2,13,ARNÉS BODY,11
CO-GRN-7,GREEN COAT,7,27,ABRIGO,20
CR-TDY-2,CORREA TIE DYE S,2,16,CORREA,14
AC-PRP-3,Arnés Clásico Purple M,2,12,ARNÉS CLÁSICO,10
AR-ALN-2,ARNÉS AJUSTABLE ALIEN S,3,18,ARNÉS AJUSTABLE,15
CL-TRT-4,Collar TURTLE L,2,11,COLLAR PERRO,9
AR-TRT-3,ARNÉS REVERSIBLE TURTLE M,4,16,ARNÉS REVERSIBLE,12
BD-BEI-2,CAMAS BEIGE S,,,CAMA,
AT-GMM-2,ARNÉS TRAIL GUMMY BEARS S,7,23,ARNÉS TRAIL,16
CL-MON-2,Collar Monstera S,2,12,COLLAR PERRO,10
AT-MMD-3,ARNÉS TRAIL MERMAID M,7,24,ARNÉS TRAIL,17
CR-GMM-4,Dukier Bears Gummy Correa L,3,16,CORREA,13
CL-MON-1,Collar Monstera XS,1,12,COLLAR PERRO,11
AT-DGT-3,ARNÉS TRAIL DOGTELLA M,7,23,ARNÉS TRAIL,16
PC-POO-U,COLGADOR DE BOLSAS POO U,1,5,COLGADOR DE BOLSAS,4
FD-BLU-2,FUNDA CAMA BLUE S,,,CAMA FUNDA,
CR-PKG-2,CORREA PINK GALAXY S,2,14,CORREA,12
CO-PRP-1,PURPLE COAT,6,22,ABRIGO,16
AC-SWT-4,ARNÉS CLÁSICO SWEETS L,3,13,ARNÉS CLÁSICO,10
CLV-YEL-4,0,3,12,PVC COLLAR PERRO,9
AC-PNK-2,Arnés Clásico Pink S,2,12,ARNÉS CLÁSICO,10
BH-AVC-4,Body Avocado L,3,11,ARNÉS BODY,8
AC-PRP-2,Arnés Clásico Purple S,2,12,ARNÉS CLÁSICO,10
CL-AVC-2,Collar AVOCADO S,2,11,COLLAR PERRO,9
AC-TRT-3,ARNÉS CLÁSICO TURTLE M,2,12,ARNÉS CLÁSICO,10
AR-BRY-4,Dukier Berry Love ArnÈs Reversible L,4,17,ARNÉS REVERSIBLE,13
CL-BEE-1,Dukier Beer Collar Xs,1,10,COLLAR PERRO,9
CR-TAT-4,CORREA TATTOO L,3,15,CORREA,12
AR-BEE-2,Dukier Beer Arnés Ajustable S,3,18,ARNÉS AJUSTABLE,15
PC-DGT-U,COLGADOR DE BOLSAS DOGTELLA U,1,5,COLGADOR DE BOLSAS,4
AC-BEI-4,CLASSIC HARNESS BEIGE L,2,9,ARNÉS CLÁSICO,7
CL-BEI-3,COLLAR BEIGE M,1,6,COLLAR PERRO,5
BH-SBL-2,BODY HARNESS SOFT BLUE S,2,6,ARNÉS BODY,4
CO-BLU-2,BLUE COAT S,6,23,ABRIGO,17
AF-MNT-0,LICK MAT MINT,3,12,LICK MAT,9
PC-SML-U,COLGADOR DE BOLSAS SMILEY U,1,6,COLGADOR DE BOLSAS,5
CLV-BEI-3,COLLAR PVC BEIGE PVC M,3,14,PVC COLLAR PERRO,11
RC-RND-4,Dukier Chubasqueros Raindrops L,5,13,CHUBASQUERO,8
PB-PKG-2,PORTA BOLSAS PINK GALAXY U,2,5,PORTA BOLSAS,3
CLV-GRN-3,COLLAR PVC GREEN PVC M,3,15,PVC COLLAR PERRO,12
CR-STC-2,CORREA STICKERS S,2,17,CORREA,15
AC-CLF-4,ARNÉS CLÁSICO CALIFORNIA L,3,10,ARNÉS CLÁSICO,7
CR-PNK-4,Correa Pink L,3,14,CORREA,11
BH-PRP-3,Body Purple M,2,10,ARNÉS BODY,8
CR-MMD-2,Dukier Mermaid Correa S,2,15,CORREA,13
AR-CLF-2,ARNÉS REVERSIBLE CALIFORNIA S,3,14,ARNÉS REVERSIBLE,11
BH-SML-3,Body Smiley M,2,13,ARNÉS BODY,11
AC-TER-3,CLASSIC HARNESS TERRACOTA M,2,9,ARNÉS CLÁSICO,7
CR-PCE-4,Dukier Peace Correa L,3,16,CORREA,13
AR-PKG-1,ARNÉS REVERSIBLE PINK GALAXY XS,3,14,ARNÉS REVERSIBLE,11
ACV-GRN-3,CLASSIC HARNESS PVC GREEN PVC M,5,19,PVC ARNÉS CLÁSICO,14
BH-RED-3,Body Red M,2,12,ARNÉS BODY,10
CG-SWT-0,Collar GATO SWEETS,1,5,GATO,4
AT-CLF-2,ARNÉS TRAIL CALIFORNIA S,7,21,ARNÉS TRAIL,14
AC-PNK-4,Arnés Clásico Pink L,3,12,ARNÉS CLÁSICO,9
CG-BLU-0,Collar Gato Blue U,1,4,GATO,3
CL-RED-3,Collar Red M,2,10,COLLAR PERRO,8
CT-MMD-0,COLETERO MERMAID U,1,5,COLETERO,4
AC-TAT-4,ARNES CLÁSICO TATTOO L,3,10,ARNÉS CLÁSICO,7
CO-GRN-6,GREEN COAT,7,26,ABRIGO,19
AR-MMD-1,Dukier Mermaid Arnés Reversible Xs,3,14,ARNÉS REVERSIBLE,11
AC-RED-3,Arnés Clásico Red M,2,12,ARNÉS CLÁSICO,10
AC-BRY-4,Dukier Berry Love ArnÈs Clásico L,3,14,ARNÉS CLÁSICO,11
AC-GMM-4,Dukier Bears Gummy Arnés Clásico L,3,13,ARNÉS CLÁSICO,10
RC-RPW-5,CHUBASQUEROS FLOWER POWER XL,5,21,CHUBASQUERO,16
RC-RBW-6,Chubasqueros Rainbow XXL,5,11,CHUBASQUERO,6
PC-GMM-U,COLGADOR BEER U,1,5,COLGADOR DE BOLSAS,4
CG-TAT-0,Collar GATO TATTOO U,1,5,GATO,4
DP-PRP-0,BEBEDERO PURPLE,2,7,BEBEDEROS,5
BH-FPW-2,BODY HARNESS FLOWER POWER S,2,9,ARNÉS BODY,7
BH-BRY-3,BODY HARNESS BERRY LOVE M,2,10,ARNÉS BODY,8
AC-PKG-3,ARNÉS CLÁSICO PINK GALAXY M,2,11,ARNÉS CLÁSICO,9
BH-TRT-3,BODY HARNESS TURTLE M,2,10,ARNÉS BODY,8
CL-RED-2,Collar Red S,2,10,COLLAR PERRO,8
AR-BRY-3,Dukier Berry Love ArnÈs Reversible M,4,17,ARNÉS REVERSIBLE,13
CR-LPG-2,Correa Cheetah Gold S,2,13,CORREA,11
AC-MMD-2,Dukier Mermaid Arnés Clásico S,2,13,ARNÉS CLÁSICO,11
FD-TRC-4,FUNDA CAMA TERRACOTA L,,,CAMA FUNDA,
PC-AVC-U,COLGADOR DE BOLSAS AVOCADO U,1,5,COLGADOR DE BOLSAS,4
CL-LPG-3,Collar Cheetah Gold M,2,9,COLLAR PERRO,7
AT-TRT-3,ARNÉS TRAIL TURTLE M,7,24,ARNÉS TRAIL,17
CLV-PNK-2,COLLAR PVC PINK PVC S,2,15,PVC COLLAR PERRO,13
CO-RED-6,RED COAT,7,26,ABRIGO,19
AR-UNC-4,ARNÉS REVERSIBLE UNICORNS L,4,16,ARNÉS REVERSIBLE,12
PJ-MMD-4,Dukier Mermaid Pajarita L,1,6,PAJARITA,5
RC-AVC-1,Dukier Chubasqueros Avocado Xs,5,12,CHUBASQUERO,7
CL-BLU-2,Collar Blue S,2,10,COLLAR PERRO,8
CR-TAT-2,CORREA TATTOO S,2,14,CORREA,12
BH-DGT-5,Body Dogtella XL,3,11,ARNÉS BODY,8
AC-DGT-3,ARNÉS CLÁSICO DOGTELLA M,2,13,ARNÉS CLÁSICO,11
CR-ALN-2,CORREA ALIEN S,2,16,CORREA,14
PB-LPG-2,Porta Bolsas Cheetah Gold U,2,5,PORTA BOLSAS,3
CLV-BLK-3,COLLAR PVC BLACKPVC M,3,14,PVC COLLAR PERRO,11
BH-TER-5,BODY HARNESS TERRACOTA XL,2,6,ARNÉS BODY,4
CL-SBL-1,COLLAR SOFT BLUE XS,1,6,COLLAR PERRO,5
CR-MNT-2,Correa Mint S,2,14,CORREA,12
MN-MMD-0,Manta Enrollable Mermaid,8,22,MANTA ENROLLABLE,14
BH-BEI-5,BODY HARNESS BEIGE XL,2,6,ARNÉS BODY,4
CL-TER-3,COLLAR TERRACOTA M,1,6,COLLAR PERRO,5
BK-AVC-U,BLANKET AVOCADO,8,21,BLANKET,13
CR-YLL-2,Correa Lime S,2,13,CORREA,11
PB-SWT-2,PORTA BOLSAS SWEETS U,2,5,PORTA BOLSAS,3
RC-AVC-5,Dukier Chubasqueros Avocado Xl,5,10,CHUBASQUERO,5
AR-LPG-3,Arnés Ajustable Cheetah Gold M,4,14,ARNÉS AJUSTABLE,10
AR-GMM-1,Dukier Bears Gummy Arnés Ajustable Xs,3,16,ARNÉS AJUSTABLE,13
PJ-TAT-2,PAJARITA TATTOO L,1,5,PAJARITA,4
CR-PRP-2,Correa Purple S,2,14,CORREA,12
AR-AVC-5,ARNÉS REVERSIBLE AVOCADO XL,5,14,ARNÉS REVERSIBLE,9
AR-TAT-3,ARNES REVERSIBLE TATTOO M,4,15,ARNÉS REVERSIBLE,11
CO-RED-5,RED COAT XL,6,25,ABRIGO,19
AC-BLU-2,Arnés clásico Blue S,2,12,ARNÉS CLÁSICO,10
CL-PNK-3,Collar Pink M,2,10,COLLAR PERRO,8
AC-MNT-2,Arnés Clásico Mint S,2,12,ARNÉS CLÁSICO,10
PBV-BEI-2,POO BAG HOLDER BEIGE PVC U,2,7,PVC PORTA BOLSAS,5
BD-BEI-4,CAMAS BEIGE L,,,CAMA,
CO-BLU-6,BLUE COAT XXL,7,26,ABRIGO,19
CL-SGR-1,COLLAR SOFT GREEN XS,1,6,COLLAR PERRO,5
BH-MNT-1,Body Mint XS,2,12,ARNÉS BODY,10
CL-SWT-2,Collar SWEETS S,2,11,COLLAR PERRO,9
AR-PCE-2,Dukier Peace Arnés Reversible S,3,16,ARNÉS REVERSIBLE,13
AR-BEE-4,Dukier Beer Arnés Ajustable L,4,18,ARNÉS AJUSTABLE,14
CR-YLL-4,Correa Lime L,3,14,CORREA,11
AR-AVC-3,ARNÉS REVERSIBLE AVOCADO M,4,15,ARNÉS REVERSIBLE,11
CO-PRP-4,PURPLE COAT L,6,25,ABRIGO,19
PBV-GRN-2,POO BAG HOLDER GREEN PVC U,2,7,PVC PORTA BOLSAS,5
CL-TRT-2,Collar TURTLE S,2,11,COLLAR PERRO,9
RC-AVC-4,Dukier Chubasqueros Avocado L,5,10,CHUBASQUERO,5
CL-PRP-3,Collar Purple M,2,10,COLLAR PERRO,8
AR-BRY-5,Dukier Berry Love ArnÈs Reversible Xl,5,19,ARNÉS REVERSIBLE,14
BH-BLU-5,Body Blue XL,3,13,ARNÉS BODY,10
CO-RED-4,RED COAT L,6,25,ABRIGO,19
AR-DGT-3,ARNÉS REVERSIBLE DOGTELLA M,4,14,ARNÉS REVERSIBLE,10
CL-BLU-1,Collar Blue XS,1,10,COLLAR PERRO,9
CR-MON-2,Correa Monstera S,2,14,CORREA,12
CO-BLU-4,BLUE COAT L,6,25,ABRIGO,19
CL-MNT-2,Collar Mint S,2,10,COLLAR PERRO,8
CRV-BLK-2,LEASH PVC BLACK PVC S,4,18,PVC CORREA,14
AR-SML-5,Arnés Ajustable Smiley XL,5,15,ARNÉS AJUSTABLE,10
CR-PNK-2,Correa Pink S,2,13,CORREA,11
AR-SML-4,Arnés Ajustable Smiley L,4,16,ARNÉS AJUSTABLE,12
AC-BEE-3,Dukier Beer Arnés Clásico M,2,13,ARNÉS CLÁSICO,11
FD-MNT-4,FUNDA CAMA MINT L,,,CAMA FUNDA,
CG-STC-0,Collar GATO STICKERS U,1,5,GATO,4
AC-PKG-2,ARNÉS CLÁSICO PINK GALAXY S,2,15,ARNÉS CLÁSICO,13
BH-RED-4,Body Red L,3,12,ARNÉS BODY,9
CO-PNK-1,PINK COAT,6,22,ABRIGO,16
AR-TRT-4,ARNÉS REVERSIBLE TURTLE L,4,16,ARNÉS REVERSIBLE,12
CG-GMM-0,Dukier Bears Gummy Collar Gato U,1,5,GATO,4
CL-PKG-4,Collar Pink GALAXY L,2,14,COLLAR PERRO,12
CG-TRT-0,Collar GATO TURTLE U,1,6,GATO,5
RC-RND-1,Dukier Chubasqueros Raindrops Xs,5,13,CHUBASQUERO,8
CG-SML-0,Collar GATO SMILEY,1,5,GATO,4
CL-TRT-1,Collar TURTLE XS,1,10,COLLAR PERRO,9
PJ-AVC-4,PAJARITA AVOCADO L,1,4,PAJARITA,3
BH-BLU-4,Body Blue L,3,13,ARNÉS BODY,10
PB-MNT-2,Porta Bolsas Mint U,2,6,PORTA BOLSAS,4
CG-CLF-0,Collar GATO CALIFORNIA U,1,5,GATO,4
CL-PKG-2,Collar Pink GALAXY S,2,9,COLLAR PERRO,7
CL-PCE-1,Dukier Peace Collar Xs,1,10,COLLAR PERRO,9
AC-PCE-2,Dukier Peace Arnés Clásico S,2,13,ARNÉS CLÁSICO,11
CL-TAT-3,Collar TATTOO M,2,11,COLLAR PERRO,9
AR-UNC-3,ARNÉS REVERSIBLE UNICORNS M,4,15,ARNÉS REVERSIBLE,11
AC-MNT-4,Arnés Clásico Mint L,3,12,ARNÉS CLÁSICO,9
CR-ALN-4,CORREA ALIEN L,3,17,CORREA,14
CR-BEE-4,Dukier Beer Correa L,3,15,CORREA,12
RC-RPW-6,CHUBASQUEROS FLOWER POWER XXL,5,21,CHUBASQUERO,16
AC-MNT-3,Arnés Clásico Mint M,2,12,ARNÉS CLÁSICO,10
AR-MON-1,Arnés Reversible Monstera XS,3,14,ARNÉS REVERSIBLE,11
BH-DGT-4,Body Dogtella L,3,12,ARNÉS BODY,9
CO-RED-3,RED COAT M,6,24,ABRIGO,18
CL-BEI-4,COLLAR BEIGE L,1,6,COLLAR PERRO,5
CO-GRN-1,GREEN COAT,6,22,ABRIGO,16
RC-AVC-2,Dukier Chubasqueros Avocado S,5,10,CHUBASQUERO,5
CL-TAT-4,Collar TATTOO L,2,11,COLLAR PERRO,9
AC-PCE-3,Dukier Peace Arnés Clásico M,2,14,ARNÉS CLÁSICO,12
AR-STC-2,ARNÉS AJUSTABLE STICKERS S,3,14,ARNÉS AJUSTABLE,11
CL-BLU-3,Collar Blue M,2,10,COLLAR PERRO,8
CR-PCE-2,Dukier Peace Correa S,2,15,CORREA,13
CL-LPG-2,Collar Cheetah Gold S,2,9,COLLAR PERRO,7
PB-ALN-2,PORTA BOLSAS ALIEN U,2,7,PORTA BOLSAS,5
AR-PKG-2,ARNÉS REVERSIBLE PINK GALAXY S,3,15,ARNÉS REVERSIBLE,12
PJ-SWT-4,PAJARITA SWEETS L,1,5,PAJARITA,4
AC-MON-2,Arnés Clásico Monstera S,2,16,ARNÉS CLÁSICO,14
CG-MON-0,Collar Gato Monstera U,1,6,GATO,5
AC-PKG-4,ARNÉS CLÁSICO PINK GALAXY L,3,10,ARNÉS CLÁSICO,7
CLV-BEI-1,COLLAR PVC BEIGE PVC XS,2,14,PVC COLLAR PERRO,12
PJ-GMM-4,Dukier Bears Gummy Pajarita L,1,6,PAJARITA,5
PJ-PCE-4,Dukier Peace Pajarita L,1,5,PAJARITA,4
PB-UNC-2,PORTA BOLSAS UNICORNS U,2,4,PORTA BOLSAS,2
PB-SBL-2,POO BAG HOLDER SOFT BLUE U,2,8,PORTA BOLSAS,6
AC-PCE-4,Dukier Peace Arnés Clásico L,3,13,ARNÉS CLÁSICO,10
CR-BEI-2,LEASH BEIGE S,2,9,CORREA,7
CO-GRN-5,GREEN COAT XL,6,25,ABRIGO,19
CG-LPG-0,Collar Gato Cheetah Gold U,1,5,GATO,4
AR-SWT-3,ARNÉS REVERSIBLE SWEETS M,4,15,ARNÉS REVERSIBLE,11
CL-GMM-1,Dukier Bears Gummy Collar Xs,1,12,COLLAR PERRO,11
CO-PRP-2,PURPLE COAT S,6,23,ABRIGO,17
CL-MNT-4,Collar Mint L,2,9,COLLAR PERRO,7
CL-MON-4,Collar Monstera L,2,13,COLLAR PERRO,11
AR-MON-2,Arnés Reversible Monstera S,3,19,ARNÉS REVERSIBLE,16
PC-BEE-U,COLGADOR GUMMY BEARS U,1,5,COLGADOR DE BOLSAS,4
CG-MMD-0,Dukier Mermaid Collar Gato U,1,5,GATO,4
CO-BLU-3,BLUE COAT M,6,24,ABRIGO,18
CL-CLF-2,Collar CALIFORNIA S,2,9,COLLAR PERRO,7
PJ-DGT-4,PAJARITA DOGTELLA L,1,5,PAJARITA,4
CL-SWT-4,Collar SWEETS L,2,13,COLLAR PERRO,11
RC-CLD-1,Dukier Chubasqueros Clouds Xs,5,12,CHUBASQUERO,7
CL-TAT-1,Collar TATTOO XS,1,10,COLLAR PERRO,9
CO-GRN-3,GREEN COAT M,6,24,ABRIGO,18
PB-TER-2,POO BAG HOLDER TERRACOTA U,2,8,PORTA BOLSAS,6
CT-GMM-0,COLETERO GUMMY BEARS U,1,6,COLETERO,5
BH-PRP-1,Body Purple XS,2,11,ARNÉS BODY,9
CL-SBL-4,COLLAR SOFT BLUE L,1,6,COLLAR PERRO,5
AC-MMD-3,Dukier Mermaid Arnés Clásico M,2,14,ARNÉS CLÁSICO,12
PJ-STC-4,PAJARITA STICKERS L,1,5,PAJARITA,4
AC-UNC-3,ARNÉS CLÁSICO UNICORNS M,2,14,ARNÉS CLÁSICO,12
CO-PNK-4,PINK COAT L,6,25,ABRIGO,19
CO-GRN-4,GREEN COAT L,6,25,ABRIGO,19
CR-SWT-2,CORREA SWEETS S,2,14,CORREA,12
AC-FPW-3,ARNÉS CLÁSICO FLOWER POWER M,2,14,ARNÉS CLÁSICO,12
CL-BLU-4,Collar Blue L,2,9,COLLAR PERRO,7
AC-ALN-4,ARNÉS CLÁSICO ALIEN L,3,15,ARNÉS CLÁSICO,12
CO-PRP-5,PURPLE COAT XL,6,25,ABRIGO,19
AR-BEE-1,Dukier Beer Arnés Ajustable Xs,3,17,ARNÉS AJUSTABLE,14
CR-CLF-2,CORREA CALIFORNIA S,2,12,CORREA,10
AC-ALN-3,ARNÉS CLÁSICO ALIEN M,2,15,ARNÉS CLÁSICO,13
AC-SGR-2,CLASSIC HARNESS SOFT GREEN S,2,9,ARNÉS CLÁSICO,7
CG-PCE-0,Dukier Peace Collar Gato U,1,5,GATO,4
CR-UNC-4,CORREA UNICORNS L,3,14,CORREA,11
BK-SML-U,BLANKET SMILEY,8,21,BLANKET,13
BH-BRY-1,BODY HARNESS BERRY LOVE XS,2,6,ARNÉS BODY,4
CG-BNN-0,Collar GATO BANANA U,1,5,GATO,4
BH-AVC-2,Body Avocado S,2,12,ARNÉS BODY,10
BH-DGT-2,Body Dogtella S,2,11,ARNÉS BODY,9
AC-SGR-3,CLASSIC HARNESS SOFT GREEN M,2,9,ARNÉS CLÁSICO,7
CO-PNK-3,PINK COAT M,6,24,ABRIGO,18
PB-YLL-2,Porta Bolsas Lime U,2,7,PORTA BOLSAS,5
CR-SBL-2,LEASH SOFT BLUE S,2,9,CORREA,7
AR-PKG-5,ARNÉS REVERSIBLE PINK GALAXY XL,5,18,ARNÉS REVERSIBLE,13
CG-MEX-0,Collar GATO MEXICO U,1,4,GATO,3
CO-PRP-7,PURPLE COAT,7,27,ABRIGO,20
RC-AVC-6,Dukier Chubasqueros AVOCADO XXL,5,10,CHUBASQUERO,5
AC-FPW-2,ARNÉS CLÁSICO FLOWER POWER S,2,14,ARNÉS CLÁSICO,12
AR-SWT-1,ARNÉS REVERSIBLE SWEETS XS,3,15,ARNÉS REVERSIBLE,12
AR-DGT-5,ARNÉS REVERSIBLE DOGTELLA XL,5,17,ARNÉS REVERSIBLE,12
CR-TER-2,LEASH TERRACOTA S,2,9,CORREA,7
CR-TER-4,LEASH TERRACOTA L,2,9,CORREA,7
CT-SWT-0,COLETERO SWEETS U,1,6,COLETERO,5
CR-VIO-4,LEASH SOFT PURPLE L,2,9,CORREA,7
AT-ALN-4,ARNÉS TRAIL ALIEN L,7,26,ARNÉS TRAIL,19
CR-RED-2,Correa Red S,2,13,CORREA,11
AC-ALN-2,ARNÉS CLÁSICO ALIEN S,2,15,ARNÉS CLÁSICO,13
AC-SGR-4,CLASSIC HARNESS SOFT GREEN L,2,9,ARNÉS CLÁSICO,7
TW-SML-0,Dukier Toallas Smiley U,4,13,TOALLA,9
CR-UNC-2,CORREA UNICORNS S,2,11,CORREA,9
CG-PRC-0,Collar GATO PRINCESS U,1,4,GATO,3
CR-SBL-4,LEASH SOFT BLUE L,2,9,CORREA,7
AC-VIO-2,CLASSIC HARNESS SOFT PURPLE S,2,9,ARNÉS CLÁSICO,7
AC-VIO-3,CLASSIC HARNESS SOFT PURPLE M,2,9,ARNÉS CLÁSICO,7
AC-SBL-3,CLASSIC HARNESS SOFT BLUE M,2,9,ARNÉS CLÁSICO,7
CLV-BEI-2,COLLAR PVC BEIGE PVC S,2,15,PVC COLLAR PERRO,13
CLV-GRN-2,COLLAR PVC GREEN PVC S,2,14,PVC COLLAR PERRO,12
CL-CLF-4,Collar CALIFORNIA L,2,9,COLLAR PERRO,7
CG-TDY-0,Collar GATO TIE DYE U,1,4,GATO,3
CL-FPW-2,Collar FLOWER POWER S,2,12,COLLAR PERRO,10
BH-FPW-1,BODY HARNESS FLOWER POWER XS,2,6,ARNÉS BODY,4
BH-TRT-1,BODY HARNESS TURTLE XS,2,6,ARNÉS BODY,4
BH-GMM-1,BODY HARNESS GUMMY BEARS XS,2,6,ARNÉS BODY,4
BH-TER-2,BODY HARNESS TERRACOTA S,2,6,ARNÉS BODY,4
BH-SGR-0,BODY HARNESS SOFT GREEN XXS,2,6,ARNÉS BODY,4
CL-SGR-2,COLLAR SOFT GREEN S,1,6,COLLAR PERRO,5
CL-VIO-2,COLLAR SOFT PURPLE S,1,6,COLLAR PERRO,5
CL-TER-2,COLLAR TERRACOTA S,1,6,COLLAR PERRO,5
CL-SBL-2,COLLAR SOFT BLUE S,1,6,COLLAR PERRO,5
CT-FPW-0,COLETERO FLOWER POWER U,1,5,COLETERO,4
CT-TRT-0,COLETERO TURTLE U,1,5,COLETERO,4
CT-AVC-0,COLETERO AVOCADO U,1,5,COLETERO,4
CT-CLF-0,COLETERO CALIFORNIA U,1,5,COLETERO,4
CG-BRY-0,Dukier Berry Love Collar Gato U,1,6,GATO,5
CG-FPW-0,Collar GATO FLOWER POWER U,1,6,GATO,5
CG-PRP-0,Collar Gato Purple U,1,5,GATO,4
CG-RED-0,Collar Gato Red U,1,5,GATO,4
CG-ALN-0,COLLAR GATO ALIEN U,1,6,GATO,5
PJ-PKG-4,PAJARITA PINK GALAXY L,1,5,PAJARITA,4
PJ-TRT-4,PAJARITA TURTLE L,1,3,PAJARITA,2
KS-BLU-1,KNIT SWEATER BLUE XS,,,KNIT SWEATER,
KS-BLU-2,KNIT SWEATER BLUE S,,,KNIT SWEATER,
KS-BLU-3,KNIT SWEATER BLUE M,,,KNIT SWEATER,
KS-BLU-4,KNIT SWEATER BLUE L,,,KNIT SWEATER,
KS-BLU-5,KNIT SWEATER BLUE XL,,,KNIT SWEATER,
KS-BLU-6,KNIT SWEATER BLUE XXL,,,KNIT SWEATER,
KS-GRN-1,KNIT SWEATER GREEN XS,,,KNIT SWEATER,
KS-GRN-2,KNIT SWEATER GREEN S,,,KNIT SWEATER,
KS-GRN-3,KNIT SWEATER GREEN M,,,KNIT SWEATER,
KS-GRN-4,KNIT SWEATER GREEN L,,,KNIT SWEATER,
KS-GRN-5,KNIT SWEATER GREEN XL,,,KNIT SWEATER,
KS-GRN-6,KNIT SWEATER GREEN XXL,,,KNIT SWEATER,
KS-RED-1,KNIT SWEATER RED XS,,,KNIT SWEATER,
KS-RED-2,KNIT SWEATER RED S,,,KNIT SWEATER,
KS-RED-3,KNIT SWEATER RED M,,,KNIT SWEATER,
KS-RED-4,KNIT SWEATER RED L,,,KNIT SWEATER,
KS-RED-5,KNIT SWEATER RED XL,,,KNIT SWEATER,
KS-RED-6,KNIT SWEATER RED XXL,,,KNIT SWEATER,
KS-YEL-1,KNIT SWEATER YELLOW XS,,,KNIT SWEATER,
KS-YEL-2,KNIT SWEATER YELLOW S,,,KNIT SWEATER,
KS-YEL-3,KNIT SWEATER YELLOW M,,,KNIT SWEATER,
KS-YEL-4,KNIT SWEATER YELLOW L,,,KNIT SWEATER,
KS-YEL-5,KNIT SWEATER YELLOW XL,,,KNIT SWEATER,
KS-YEL-6,KNIT SWEATER YELLOW XXL,,,KNIT SWEATER,
KS-MNT-1,KNIT SWEATER MINT XS,,,KNIT SWEATER,
KS-MNT-2,KNIT SWEATER MINT S,,,KNIT SWEATER,
KS-MNT-3,KNIT SWEATER MINT M,,,KNIT SWEATER,
KS-MNT-4,KNIT SWEATER MINT L,,,KNIT SWEATER,
KS-MNT-5,KNIT SWEATER MINT XL,,,KNIT SWEATER,
KS-PNK-1,KNIT SWEATER PINK XS,,,KNIT SWEATER,
KS-PNK-2,KNIT SWEATER PINK S,,,KNIT SWEATER,
KS-PNK-3,KNIT SWEATER PINK M,,,KNIT SWEATER,
KS-PNK-4,KNIT SWEATER PINK L,,,KNIT SWEATER,
KS-PNK-5,KNIT SWEATER PINK XL,,,KNIT SWEATER,
KS-PRP-1,KNIT SWEATER PURPLE XS,,,KNIT SWEATER,
KS-PRP-2,KNIT SWEATER PURPLE S,,,KNIT SWEATER,
KS-PRP-3,KNIT SWEATER PURPLE M,,,KNIT SWEATER,
KS-PRP-4,KNIT SWEATER PURPLE L,,,KNIT SWEATER,
KS-PRP-5,KNIT SWEATER PURPLE XL,,,KNIT SWEATER,
AR-CLF-3,ARNÉS REVERSIBLE CALIFORNIA M,4,14,ARNÉS REVERSIBLE,10
CRV-PRP-2,0,4,15,PVC CORREA,11
CLV-COR-1,0,2,8,PVC COLLAR PERRO,6
CLV-COR-2,0,2,8,PVC COLLAR PERRO,6
CLV-COR-3,0,3,11,PVC COLLAR PERRO,8
CRV-COR-2,0,4,15,PVC CORREA,11
CRV-COR-4,0,4,17,PVC CORREA,13
CLV-PRP-1,0,2,8,PVC COLLAR PERRO,6
CLV-PRP-2,0,2,8,PVC COLLAR PERRO,6
CLV-PRP-3,0,3,11,PVC COLLAR PERRO,8
CRV-PRP-4,0,4,17,PVC CORREA,13
CLV-SGR-1,0,2,8,PVC COLLAR PERRO,6
CLV-SGR-2,0,2,8,PVC COLLAR PERRO,6
CLV-SGR-3,0,3,11,PVC COLLAR PERRO,8
CRV-SGR-2,0,4,15,PVC CORREA,11
CRV-SGR-4,0,4,17,PVC CORREA,13
CLV-YEL-1,0,2,8,PVC COLLAR PERRO,6
CLV-YEL-2,0,2,8,PVC COLLAR PERRO,6
CLV-YEL-3,0,3,11,PVC COLLAR PERRO,8
CRV-YEL-2,0,4,15,PVC CORREA,11
CRV-YEL-4,0,4,17,PVC CORREA,13
CLV-BLK-1,COLLAR PVC BLACK PVC XS,2,13,PVC COLLAR PERRO,11
AR-CLF-1,ARNÉS REVERSIBLE CALIFORNIA XS,3,13,ARNÉS REVERSIBLE,10
CL-CLF-3,Collar CALIFORNIA M,2,9,COLLAR PERRO,7
CL-DGT-2,Collar DOGTELLA S,2,9,COLLAR PERRO,7
CL-DGT-3,Collar DOGTELLA M,2,9,COLLAR PERRO,7
CL-RED-1,Collar Red XS,1,9,COLLAR PERRO,8
CG-PNK-0,Collar Gato Pink U,1,5,GATO,4
AR-DGT-4,ARNÉS REVERSIBLE DOGTELLA L,4,15,ARNÉS REVERSIBLE,11
CR-PLN-4,CORREA PLANTS L,3,17,CORREA,14
CR-TDY-4,CORREA TIE DYE L,3,18,CORREA,15
CL-STC-2,Collar STICKERS S,2,14,COLLAR PERRO,12
CL-LPG-1,Collar Cheetah Gold XS,1,11,COLLAR PERRO,10
CL-PKG-1,Collar Pink GALAXY XS,1,9,COLLAR PERRO,8
CO-PNK-7,PINK COAT,7,27,ABRIGO,20
CO-RED-7,RED COAT,7,27,ABRIGO,20
CL-STC-1,Collar STICKERS XS,1,14,COLLAR PERRO,13
CL-UNC-1,Collar UNICORNS XS,1,10,COLLAR PERRO,9
PJ-CLF-4,PAJARITA CALIFORNIA L,1,5,PAJARITA,4
PJ-UNC-4,PAJARITA UNICORNS L,1,5,PAJARITA,4
CL-BEI-1,COLLAR BEIGE XS,1,6,COLLAR PERRO,5
PJ-ALN-4,PAJARITA ALIEN U,1,6,PAJARITA,5
CO-PNK-6,PINK COAT,7,26,ABRIGO,19
CO-BLU-5,BLUE COAT XL,6,25,ABRIGO,19
CO-PNK-5,PINK COAT XL,6,25,ABRIGO,19
CO-BLU-1,BLUE COAT XS,6,22,ABRIGO,16
CT-UNC-0,COLETERO UNICORNS U,1,5,COLETERO,4
RC-UNC-2,CHUBASQUEROS UNICORNS S,5,9,CHUBASQUERO,4
RC-UNC-4,CHUBASQUEROS UNICORNS L,5,9,CHUBASQUERO,4
RC-UNC-6,CHUBASQUEROS UNICORNS XXL,5,9,CHUBASQUERO,4
RC-UNC-3,CHUBASQUEROS UNICORNS M,5,9,CHUBASQUERO,4
RC-UNC-5,CHUBASQUEROS UNICORNS XL,5,9,CHUBASQUERO,4
CO-PRP-6,PURPLE COAT,7,26,ABRIGO,19
